id	spanish	english
start	Empezar	Start
settings	Opciones	Settings
exit	Salir	Exit
title	Título	Title
language	Idioma	Llanguage
volume	Volumen	Volume
quality	Calidad	Quality
resolution	Resolución	Resolution
fast	Rápidos	Fast
good	Buenos	Good
fantastic	Fantásticos	Fantastic
ultra	Ultra	Ultra
fullscreen	Pantalla completa	Fullscreen
back	Atrás	Back
game over	Fin del juego	Game Over
pause	Pausa	Pause
your score	Tu puntuación	Your Score
best score	Mejor puntuación	Best Score
go	Ya	Go